#########
#   #   #
# K #   #
#   #   #
#S  D  R#
#   #   #
# K #   #
#   #   #
#########