#########################
#   #   #   #   #   #   #
# K # K # K # K # K #   #
#   #   #   #   #   #   #
#S  D  RDS RD  RDS RD  R#
#   #   #   #   #   #   #
# K # K # K # K # K #   #
#   #   #   #   #   #   #
#########################