#################
#   #   #   #   #
# K # K # K #   #
#   #   #   #   #
#S  D  RD  RD  R#
#   #   #   #   #
# K # K # K #   #
#   #   #   #   #
#################