#####################
#     K   #         #
#         #  K      #
#         #         #
#         #         #
#S        D     R   #
##################D##
#R     #            #
#      D            #
#      #            #
#     K#            #
#      #            #
#      #R      K    #
###D#################
#                   #
#         #         #
#         #         #
#         #R        #
#         #         #
#                   #
#####################